00 00 00 00 00 00 00 00 00 00 00 00 00 00 00 00 00 00 00 00 00 00 00 00 00 00 00 00 01 01 01 01 01 01 01 01 01 01 01 01 01 01 01 01 01 00 00 00 00 00    
00 01 01 01 01 01 01 01 01 01 01 00 00 00 00 00 00 00 00 00 01 01 01 01 01 01 01 00 01 00 00 00 00 00 00 00 00 00 00 00 00 00 00 00 01 01 01 01 01 01
00 01 01 01 01 00 00 01 01 00 00 00 01 01 01 01 01 01 01 01 01 00 00 00 00 00 01 00 01 05 06 05 06 05 06 02 02 02 02 05 06 05 06 05 00 00 00 00 00 01
00 01 01 01 01 01 00 01 01 00 00 00 01 00 00 00 00 01 00 00 00 00 00 00 00 00 01 00 01 06 05 02 02 02 02 05 06 05 06 02 02 02 02 00 00 00 00 00 00 01
00 00 01 01 00 01 01 01 00 00 00 00 01 00 00 00 00 01 00 00 00 00 01 01 01 03 01 00 01 05 06 05 06 05 06 02 02 02 02 05 06 05 06 05 01 01 01 02 00 01
00 01 01 01 01 01 01 00 01 00 00 00 01 00 00 01 01 01 01 01 00 00 01 00 01 06 01 00 01 06 05 06 02 02 02 02 05 06 05 04 03 04 02 02 01 00 01 00 04 01
00 00 01 00 01 00 00 00 00 00 00 00 01 00 00 01 01 01 00 01 01 00 01 00 01 03 01 00 01 05 06 05 06 05 06 02 02 05 06 05 06 05 02 05 01 00 01 04 00 01
00 01 01 01 01 00 00 00 00 00 00 00 01 00 01 01 01 01 01 01 01 00 01 00 01 06 01 00 01 06 05 06 02 02 02 02 05 06 03 04 03 04 02 02 01 00 01 00 04 01
01 01 01 01 01 01 01 01 00 00 00 00 01 00 01 00 00 01 00 00 00 00 01 00 01 03 01 00 01 05 04 03 04 02 02 02 02 05 06 05 06 05 06 02 01 00 01 04 00 01
01 00 00 00 00 00 00 01 01 01 01 01 01 00 01 00 00 01 00 00 00 00 01 00 01 06 01 00 01 00 00 04 03 04 03 04 00 00 00 00 00 00 00 00 01 00 01 00 04 01
01 00 00 00 00 00 00 00 00 00 00 00 00 00 01 00 00 01 00 01 01 01 01 00 01 03 01 00 01 00 00 00 00 00 00 03 04 03 04 03 00 00 00 00 01 00 01 04 00 01
01 00 00 00 00 01 01 01 01 01 01 01 01 01 01 00 00 01 00 01 00 00 00 00 01 06 01 00 01 00 00 00 05 06 05 06 00 00 00 00 00 00 00 00 01 00 01 00 04 01
01 00 00 00 00 01 00 00 00 01 00 00 00 00 01 00 00 01 00 01 01 01 00 01 01 03 01 00 01 00 00 00 00 00 06 05 06 05 00 00 00 00 01 00 01 00 01 04 00 01
01 00 00 00 00 01 00 00 00 01 00 00 00 00 01 01 01 01 00 00 00 01 00 01 00 06 01 00 01 00 00 00 00 00 00 00 00 00 00 00 00 00 00 00 01 00 01 00 04 01
01 01 00 00 00 01 00 00 00 01 00 00 00 00 00 00 00 00 00 00 00 01 00 01 00 00 01 00 01 00 00 00 00 00 00 00 00 00 00 00 01 00 00 00 01 00 01 04 00 01
01 01 01 00 00 01 00 00 00 01 00 00 00 00 00 00 00 00 00 00 00 01 00 01 00 00 01 00 01 01 00 00 03 04 03 04 03 00 00 00 00 00 00 00 01 00 01 00 04 01
00 00 01 03 00 01 00 00 00 01 01 01 01 01 01 00 00 00 00 00 00 01 02 01 00 00 01 00 01 01 01 01 00 00 01 01 01 01 01 01 01 01 01 01 01 00 01 04 00 01
00 00 01 00 03 01 00 00 00 00 01 00 00 00 00 00 00 00 01 01 01 01 02 01 00 00 01 00 00 00 00 01 00 00 01 00 00 00 00 00 00 00 00 00 00 00 01 02 00 01
00 00 01 03 00 01 00 00 00 00 01 00 01 01 01 00 00 00 01 00 01 00 02 01 00 00 01 00 00 00 00 01 00 00 01 00 00 00 00 00 00 00 00 00 00 00 01 05 06 01
00 00 01 00 03 01 00 00 00 00 01 00 00 00 01 00 00 00 01 00 01 00 00 01 00 05 01 00 00 00 00 01 00 00 01 01 01 01 01 01 01 01 01 00 00 00 01 06 02 01
00 00 01 03 00 01 00 01 01 01 01 00 01 01 01 00 00 00 01 00 01 00 00 01 02 06 01 00 00 00 00 01 00 00 00 00 00 00 00 00 00 00 01 00 00 00 01 05 01 01
00 00 01 00 03 01 00 01 01 01 01 00 01 00 00 00 00 00 01 00 01 00 00 01 00 05 01 01 01 01 01 01 01 01 01 01 01 01 01 01 00 00 01 00 00 00 01 06 01 00
00 00 01 03 00 01 00 01 01 07 00 00 01 00 00 00 00 00 01 00 01 01 00 01 04 06 02 02 02 02 02 05 06 03 04 03 04 03 04 03 00 00 01 00 00 00 01 05 01 00
00 00 01 00 03 01 00 01 01 07 07 02 01 00 00 00 00 00 01 00 00 01 00 01 06 05 06 05 06 05 06 00 00 01 01 01 01 01 01 01 01 01 01 00 00 00 01 06 01 00
00 00 01 03 00 01 00 01 01 01 01 01 01 00 00 00 00 00 01 00 00 01 00 01 01 01 01 01 01 01 01 01 00 01 00 00 00 00 00 00 00 00 00 00 00 00 01 05 01 00
00 00 01 00 03 01 00 01 01 01 01 01 01 00 00 00 00 00 01 00 00 01 00 00 00 00 00 00 00 00 00 01 00 01 01 01 00 00 00 01 01 01 01 01 01 01 01 06 01 00
00 00 01 06 00 01 00 01 01 01 01 01 01 01 01 01 00 00 01 00 00 01 00 00 01 00 00 00 01 00 00 01 00 00 00 01 00 00 00 01 00 00 00 00 00 00 00 05 01 00
00 00 01 00 06 01 00 00 00 00 00 00 00 00 00 01 00 00 01 00 00 01 00 00 00 00 00 00 00 00 00 01 00 00 00 01 00 00 00 01 00 00 01 01 01 01 01 01 01 00
00 00 01 06 00 01 01 01 01 01 01 01 01 01 01 01 01 01 01 00 00 01 01 01 01 01 01 01 01 01 01 01 01 01 01 01 01 01 01 01 00 00 01 01 01 01 00 00 00 00
00 00 01 00 06 02 02 02 02 03 04 03 04 03 04 02 02 02 02 05 06 05 06 05 06 02 02 02 02 05 06 05 06 05 06 02 02 02 02 00 00 00 01 01 01 00 00 00 00 00
00 00 01 06 03 04 03 04 03 04 02 02 02 02 03 04 03 04 03 04 02 02 02 02 05 06 05 06 05 06 02 02 02 02 05 06 05 06 05 06 00 00 01 01 00 01 00 00 00 00
00 00 01 01 01 01 01 01 01 01 01 01 01 01 01 01 01 01 01 01 01 01 01 01 01 01 01 01 01 01 01 01 01 01 01 01 01 01 01 01 01 01 01 00 00 00 00 00 00 00