05 05 05 05 05 05 05 05 05 05 05 05 05 05 05 05 05 05 05 05 05 05 05 05 05 05 05 05 32 32 32 32 32 32 32 32 32 32 32 32 32 32 32 32 32 05 05 05 05 05    
05 10 10 10 10 10 10 10 10 10 10 05 05 05 05 05 05 05 05 05 32 32 32 32 32 32 32 05 32 05 05 05 05 05 05 05 05 05 05 05 05 05 05 05 32 32 32 32 32 32
05 10 18 10 10 05 05 10 18 05 05 05 32 32 32 32 32 32 32 32 32 05 05 05 05 05 32 05 32 17 17 17 17 -17 17 15 15 15 15 17 17 17 17 17 05 05 05 05 05 32
05 10 10 10 10 10 05 10 10 05 05 05 32 05 05 05 05 32 05 05 05 05 05 05 05 05 32 05 32 17 17 15 15 15 15 17 17 17 17 15 15 15 15 05 05 05 05 05 05 32
05 05 10 10 05 10 10 10 05 05 05 05 32 05 05 05 05 32 05 05 05 05 32 32 32 16 32 05 32 17 17 17 17 17 17 15 15 15 15 17 17 17 17 17 32 32 32 15 05 32
05 10 18 10 10 10 10 05 18 05 05 05 32 05 05 32 32 32 32 32 05 05 32 05 32 17 32 05 32 17 17 17 15 15 15 15 17 17 17 16 16 16 15 15 32 05 32 05 16 32
05 05 10 05 10 05 05 05 05 05 05 05 32 05 05 32 10 10 05 32 32 05 32 05 32 16 32 05 32 17 17 17 17 17 17 15 15 17 17 17 17 17 15 17 32 05 32 16 05 32
05 10 10 10 10 05 05 05 05 05 05 05 32 05 32 32 10 32 32 32 32 05 32 05 32 17 32 05 32 17 17 17 15 15 15 15 17 17 16 16 16 17 15 15 32 05 32 05 16 32
32 32 32 32 32 32 32 32 05 05 05 05 32 05 32 05 05 32 05 05 05 05 32 05 32 16 32 05 32 17 16 16 16 15 15 15 15 17 17 17 17 17 17 15 32 05 32 16 05 32
32 05 05 05 05 05 05 32 32 32 32 32 32 05 32 05 05 32 05 05 05 05 32 05 32 17 32 05 32 05 05 16 16 16 16 16 05 05 05 05 05 05 05 05 32 05 32 05 16 32
32 05 05 05 05 05 05 05 05 05 05 05 05 05 32 05 05 32 05 32 32 32 32 05 32 16 32 05 32 05 05 05 05 05 05 16 16 16 16 16 05 05 05 05 32 05 32 16 05 32
32 05 05 05 05 32 32 32 32 32 32 32 32 32 32 05 05 32 05 32 05 05 05 05 32 17 32 05 32 05 05 05 17 17 17 17 05 05 05 05 05 05 05 05 32 05 32 05 16 32
32 05 05 05 05 32 05 05 05 32 05 05 05 05 32 05 05 32 05 32 32 32 05 32 32 16 32 05 32 05 05 05 05 05 17 17 17 17 05 05 05 05 18 05 32 05 32 16 05 32
32 05 05 05 05 32 05 05 05 32 05 05 05 05 32 32 32 32 05 05 05 32 05 32 05 17 32 05 32 05 05 05 05 05 05 05 05 05 05 05 05 05 05 05 32 05 32 05 16 32
32 18 05 05 05 32 05 05 05 32 05 05 05 05 05 05 05 05 05 05 05 32 05 32 05 05 32 05 32 05 05 05 05 05 05 05 05 05 05 05 18 05 05 05 32 05 32 16 05 32
32 32 32 05 05 32 05 05 05 32 05 05 05 05 05 05 05 05 05 05 05 32 05 32 05 05 32 05 32 18 05 05 16 16 16 16 16 05 05 05 05 05 05 05 32 05 32 05 16 32
05 05 32 16 05 32 05 05 05 32 32 32 32 32 32 05 05 05 05 05 05 32 15 32 05 05 32 05 32 32 32 32 05 05 32 32 32 32 32 32 32 32 32 32 32 05 32 16 05 32
05 05 32 05 16 32 05 05 05 05 32 05 05 05 05 05 05 05 32 32 32 32 15 32 05 05 32 05 05 05 05 32 05 05 32 05 05 05 05 05 05 05 05 05 05 05 32 15 05 32
05 05 32 16 05 32 05 05 05 05 32 05 32 32 32 05 05 05 32 05 32 05 15 32 05 05 32 05 05 05 05 32 05 05 32 05 05 05 05 05 05 05 05 05 05 05 32 17 17 32
05 05 32 05 16 32 05 05 05 05 32 05 05 05 32 05 05 05 32 05 32 05 05 32 05 17 32 05 05 05 05 32 05 05 32 32 32 32 32 32 32 32 32 05 05 05 32 17 15 32
05 05 32 16 05 32 05 32 32 32 32 -5 32 32 32 05 05 05 32 05 32 05 05 32 15 17 32 05 05 05 05 32 05 05 05 05 05 05 05 05 05 05 32 05 05 05 32 17 32 32
05 05 32 05 16 32 05 32 10 10 10 05 32 05 05 05 05 05 32 05 32 05 05 32 05 17 32 32 32 32 32 32 32 32 32 32 32 32 32 32 05 05 32 05 05 05 32 17 32 05
05 05 32 16 05 32 05 32 10 11 12 05 32 05 05 05 05 05 32 05 32 32 05 32 16 17 15 15 15 15 15 17 17 16 16 16 16 16 16 16 05 05 32 05 05 05 32 17 32 05
05 05 32 05 16 32 05 32 10 13 14 15 32 05 05 05 05 05 32 05 05 32 05 32 17 17 17 17 17 17 17 05 05 32 32 32 32 32 32 32 32 32 32 05 05 05 32 17 32 05
05 05 32 16 05 32 05 32 32 10 10 32 32 05 05 05 05 05 32 05 05 32 05 32 32 32 32 32 32 32 32 32 05 32 05 05 05 05 05 05 05 05 05 05 05 05 32 17 32 05
05 05 32 05 16 32 05 32 10 10 10 10 32 05 05 05 05 05 32 05 05 32 05 05 05 05 05 05 05 05 05 32 05 32 32 32 05 05 05 32 32 32 32 32 32 32 32 17 32 05
05 05 32 17 05 32 05 32 32 32 32 32 32 32 32 32 05 05 32 05 05 32 05 05 18 05 05 05 18 05 05 32 05 05 05 32 05 05 05 32 05 05 05 05 05 05 05 17 32 05
05 05 32 05 17 32 05 05 05 05 05 05 05 05 05 32 05 05 32 05 05 32 05 05 05 05 05 05 05 05 05 32 05 05 05 32 05 05 05 32 05 05 32 32 32 32 32 32 32 05
05 05 32 17 05 32 32 32 32 32 32 32 32 32 32 32 32 32 32 05 05 32 32 32 32 32 32 32 32 32 32 32 32 32 32 32 32 32 32 32 05 05 32 10 10 10 05 05 05 05
05 05 32 05 17 15 15 15 15 16 16 16 16 16 16 15 15 15 15 17 17 17 17 17 17 15 15 15 15 17 17 17 17 17 17 15 15 15 15 05 05 05 32 10 10 05 05 05 05 05
05 05 32 17 16 16 16 16 16 16 15 15 15 15 16 16 16 16 16 16 15 15 15 15 17 17 17 17 17 17 15 15 15 15 17 17 17 17 17 17 05 05 32 10 05 18 05 05 05 05
05 05 32 32 32 32 32 32 32 32 32 32 32 32 32 32 32 32 32 32 32 32 32 32 32 32 32 32 32 32 32 32 32 32 32 32 32 32 32 32 32 32 32 05 05 05 05 05 05 05